OOO = "countries/OOO.txt"
OOI = "countries/OOI - Corsica.txt"
OOZ = "countries/OOZ - Lazio.txt"
OOE = "countries/OOE - Swiss Plateau.txt"
OOA = "countries/OOA - Lower Austria.txt"
OOS = "countries/OOS - Ermland-Masuren.txt"
OOL = "countries/OOL - Vlaanderen.txt"
OOF = "countries/OOF - Holland.txt"
OOB = "countries/OOB - Luxemburg.txt"
OOY = "countries/OOY - Bohemia.txt"
OIO = "countries/OIO - Warszawa.txt"
OII = "countries/OII - Kaunas.txt"
OIZ = "countries/OIZ - Vidzeme.txt"
OIE = "countries/OIE - Pärnu.txt"
OIA = "countries/OIA - Brittany.txt"
OIS = "countries/OIS - Normandy.txt"
OIL = "countries/OIL - Ile de France.txt"
OIF = "countries/OIF - Franche-Comte.txt"
OIB = "countries/OIB - Champagne.txt"
OIY = "countries/OIY - Aquitaine.txt"
OZO = "countries/OZO - Rhone.txt"
OZI = "countries/OZI - Bouches-du-Rhône.txt"
OZZ = "countries/OZZ - Languedoc.txt"
OZE = "countries/OZE - Poitou.txt"
OZA = "countries/OZA - Centre.txt"
OZS = "countries/OZS - Limousin.txt"
OZL = "countries/OZL - Auvergne.txt"
OZF = "countries/OZF - Bourgogne.txt"
OZB = "countries/OZB - Alsace-Lorraine.txt"
OZY = "countries/OZY - Nord-Pas-de-Calais.txt"
OEO = "countries/OEO - Loire.txt"
OEI = "countries/OEI - Midi Pyrenees.txt"
OEZ = "countries/OEZ - Alpes.txt"
OEE = "countries/OEE - Centre-Sud.txt"
OEA = "countries/OEA - Wallonie.txt"
OES = "countries/OES - Brabant.txt"
OEL = "countries/OEL - Friesland.txt"
OEF = "countries/OEF - Sjaelland.txt"
OEB = "countries/OEB - Gävleborg.txt"
OEY = "countries/OEY - Alto Adige.txt"
OAO = "countries/OAO - Altai Krai.txt"
OAI = "countries/OAI - .txt"
OAZ = "countries/OAZ - .txt"
OAE = "countries/OAE - .txt"
OAA = "countries/OAA - .txt"
OAS = "countries/OAS - .txt"
OAL = "countries/OAL - .txt"
OAF = "countries/OAF - .txt"
OAB = "countries/OAB - .txt"
OAY = "countries/OAY - .txt"
OSO = "countries/OSO - .txt"
OSI = "countries/OSI - .txt"
OSZ = "countries/OSZ - .txt"
OSE = "countries/OSE - .txt"
OSA = "countries/OSA - .txt"
OSS = "countries/OSS - .txt"
OSL = "countries/OSL - .txt"
OSF = "countries/OSF - .txt"
OSB = "countries/OSB - .txt"
OSY = "countries/OSY - .txt"
OLO = "countries/OLO - .txt"
OLI = "countries/OLI - .txt"
OLZ = "countries/OLZ - .txt"
OLE = "countries/OLE - .txt"
OLA = "countries/OLA - .txt"
OLS = "countries/OLS - .txt"
OLL = "countries/OLL - .txt"
OLF = "countries/OLF - .txt"
OLB = "countries/OLB - .txt"
OLY = "countries/OLY - .txt"
OFO = "countries/OFO - .txt"
OFI = "countries/OFI - .txt"
OFZ = "countries/OFZ - .txt"
OFE = "countries/OFE - .txt"
OFA = "countries/OFA - .txt"
OFS = "countries/OFS - .txt"
OFL = "countries/OFL - .txt"
OFF = "countries/OFF - .txt"
OFB = "countries/OFB - .txt"
OFY = "countries/OFY - .txt"
OBO = "countries/OBO - .txt"
OBI = "countries/OBI - .txt"
OBZ = "countries/OBZ - .txt"
OBE = "countries/OBE - .txt"
OBA = "countries/OBA - .txt"
OBS = "countries/OBS - .txt"
OBL = "countries/OBL - .txt"
OBF = "countries/OBF - .txt"
OBB = "countries/OBB - .txt"
OBY = "countries/OBY - .txt"
OYO = "countries/OYO - .txt"
OYI = "countries/OYI - .txt"
OYZ = "countries/OYZ - .txt"
OYE = "countries/OYE - .txt"
OYA = "countries/OYA - .txt"
OYS = "countries/OYS - .txt"
OYL = "countries/OYL - .txt"
OYF = "countries/OYF - .txt"
OYB = "countries/OYB - .txt"
OYY = "countries/OYY - .txt"
IOO = "countries/IOO - .txt"
IOI = "countries/IOI - .txt"
IOZ = "countries/IOZ - .txt"
IOE = "countries/IOE - .txt"
IOA = "countries/IOA - .txt"
IOS = "countries/IOS - .txt"
IOL = "countries/IOL - .txt"
IOF = "countries/IOF - .txt"
IOB = "countries/IOB - .txt"
IOY = "countries/IOY - .txt"
IIO = "countries/IIO - .txt"
III = "countries/III - .txt"
IIZ = "countries/IIZ - .txt"
IIE = "countries/IIE - .txt"
IIA = "countries/IIA - .txt"
IIS = "countries/IIS - .txt"
IIL = "countries/IIL - .txt"
IIF = "countries/IIF - .txt"
IIB = "countries/IIB - .txt"
IIY = "countries/IIY - .txt"
IZO = "countries/IZO - .txt"
IZI = "countries/IZI - .txt"
IZZ = "countries/IZZ - .txt"
IZE = "countries/IZE - .txt"
IZA = "countries/IZA - .txt"
IZS = "countries/IZS - .txt"
IZL = "countries/IZL - .txt"
IZF = "countries/IZF - .txt"
IZB = "countries/IZB - .txt"
IZY = "countries/IZY - .txt"
IEO = "countries/IEO - .txt"
IEI = "countries/IEI - .txt"
IEZ = "countries/IEZ - .txt"
IEE = "countries/IEE - .txt"
IEA = "countries/IEA - .txt"
IES = "countries/IES - .txt"
IEL = "countries/IEL - .txt"
IEF = "countries/IEF - .txt"
IEB = "countries/IEB - .txt"
IEY = "countries/IEY - .txt"
IAO = "countries/IAO - .txt"
IAI = "countries/IAI - .txt"
IAZ = "countries/IAZ - .txt"
IAE = "countries/IAE - .txt"
IAA = "countries/IAA - .txt"
JBT = "countries/JBT - .txt" # IAS
IAL = "countries/IAL - .txt"
IAF = "countries/IAF - .txt"
IAB = "countries/IAB - .txt"
IAY = "countries/IAY - .txt"
ISO = "countries/ISO - .txt"
ISI = "countries/ISI - .txt"
ISZ = "countries/ISZ - .txt"
ISE = "countries/ISE - .txt"
ISA = "countries/ISA - .txt"
ISS = "countries/ISS - .txt"
ISL = "countries/ISL - .txt"
ISF = "countries/ISF - .txt"
ISB = "countries/ISB - .txt"
ISY = "countries/ISY - .txt"
ILO = "countries/ILO - .txt"
ILI = "countries/ILI - .txt"
ILZ = "countries/ILZ - .txt"
ILE = "countries/ILE - .txt"
ILA = "countries/ILA - .txt"
ILS = "countries/ILS - .txt"
ILL = "countries/ILL - .txt"
ILF = "countries/ILF - .txt"
ILB = "countries/ILB - .txt"
ILY = "countries/ILY - .txt"
IFO = "countries/IFO - .txt"
IFI = "countries/IFI - .txt"
IFZ = "countries/IFZ - .txt"
IFE = "countries/IFE - .txt"
IFA = "countries/IFA - .txt"
IFS = "countries/IFS - .txt"
IFL = "countries/IFL - .txt"
IFF = "countries/IFF - .txt"
IFB = "countries/IFB - .txt"
IFY = "countries/IFY - .txt"
IBO = "countries/IBO - .txt"
IBI = "countries/IBI - .txt"
IBZ = "countries/IBZ - .txt"
IBE = "countries/IBE - .txt"
IBA = "countries/IBA - .txt"
IBS = "countries/IBS - .txt"
IBL = "countries/IBL - .txt"
IBF = "countries/IBF - .txt"
IBB = "countries/IBB - .txt"
IBY = "countries/IBY - .txt"
IYO = "countries/IYO - .txt"
IYI = "countries/IYI - .txt"
IYZ = "countries/IYZ - .txt"
IYE = "countries/IYE - .txt"
IYA = "countries/IYA - .txt"
IYS = "countries/IYS - .txt"
IYL = "countries/IYL - .txt"
IYF = "countries/IYF - .txt"
IYB = "countries/IYB - .txt"
IYY = "countries/IYY - .txt"
ZOO = "countries/ZOO - .txt"
ZOI = "countries/ZOI - .txt"
ZOZ = "countries/ZOZ - .txt"
ZOE = "countries/ZOE - .txt"
ZOA = "countries/ZOA - .txt"
ZOS = "countries/ZOS - .txt"
ZOL = "countries/ZOL - .txt"
ZOF = "countries/ZOF - .txt"
ZOB = "countries/ZOB - .txt"
ZOY = "countries/ZOY - .txt"
ZIO = "countries/ZIO - .txt"
ZII = "countries/ZII - .txt"
ZIZ = "countries/ZIZ - .txt"
ZIE = "countries/ZIE - .txt"
ZIA = "countries/ZIA - .txt"
ZIS = "countries/ZIS - .txt"
ZIL = "countries/ZIL - .txt"
ZIF = "countries/ZIF - .txt"
ZIB = "countries/ZIB - .txt"
ZIY = "countries/ZIY - .txt"
ZZO = "countries/ZZO - .txt"
ZZI = "countries/ZZI - .txt"
ZZZ = "countries/ZZZ - .txt"
ZZE = "countries/ZZE - .txt"
ZZA = "countries/ZZA - .txt"
ZZS = "countries/ZZS - .txt"
ZZL = "countries/ZZL - .txt"
ZZF = "countries/ZZF - .txt"
ZZB = "countries/ZZB - .txt"
ZZY = "countries/ZZY - .txt"
ZEO = "countries/ZEO - .txt"
ZEI = "countries/ZEI - .txt"
ZEZ = "countries/ZEZ - .txt"
ZEE = "countries/ZEE - .txt"
ZEA = "countries/ZEA - .txt"
ZES = "countries/ZES - .txt"
ZEL = "countries/ZEL - .txt"
ZEF = "countries/ZEF - .txt"
ZEB = "countries/ZEB - .txt"
ZEY = "countries/ZEY - .txt"
ZAO = "countries/ZAO - .txt"
ABJ = "countries/ZAI - .txt"
ZAZ = "countries/ZAZ - .txt"
ZAE = "countries/ZAE - .txt"
ZAA = "countries/ZAA - .txt"
ZAS = "countries/ZAS - .txt"
ZAL = "countries/ZAL - .txt"
ZAF = "countries/ZAF - .txt"
ZAB = "countries/ZAB - .txt"
ZAY = "countries/ZAY - .txt"
ZSO = "countries/ZSO - .txt"
ZSI = "countries/ZSI - .txt"
ZSZ = "countries/ZSZ - .txt"
ZSE = "countries/ZSE - .txt"
ZSA = "countries/ZSA - .txt"
ZSS = "countries/ZSS - .txt"
ZSL = "countries/ZSL - .txt"
ZSF = "countries/ZSF - .txt"
ZSB = "countries/ZSB - .txt"
ZSY = "countries/ZSY - .txt"
ZLO = "countries/ZLO - .txt"
ZLI = "countries/ZLI - .txt"
ZLZ = "countries/ZLZ - .txt"
ZLE = "countries/ZLE - .txt"
ZLA = "countries/ZLA - .txt"
ZLS = "countries/ZLS - .txt"
ZLL = "countries/ZLL - .txt"
ZLF = "countries/ZLF - .txt"
ZLB = "countries/ZLB - .txt"
ZLY = "countries/ZLY - .txt"
ZFO = "countries/ZFO - .txt"
ZFI = "countries/ZFI - .txt"
ZFZ = "countries/ZFZ - .txt"
ZFE = "countries/ZFE - .txt"
ZFA = "countries/ZFA - .txt"
ZFS = "countries/ZFS - .txt"
ZFL = "countries/ZFL - .txt"
ZFF = "countries/ZFF - .txt"
ZFB = "countries/ZFB - .txt"
ZFY = "countries/ZFY - .txt"
ZBO = "countries/ZBO - .txt"
ZBI = "countries/ZBI - .txt"
ZBZ = "countries/ZBZ - .txt"
ZBE = "countries/ZBE - .txt"
ZBA = "countries/ZBA - .txt"
ZBS = "countries/ZBS - .txt"
ZBL = "countries/ZBL - .txt"
ZBF = "countries/ZBF - .txt"
ZBB = "countries/ZBB - .txt"
ZBY = "countries/ZBY - .txt"
ZYO = "countries/ZYO - .txt"
ZYI = "countries/ZYI - .txt"
ZYZ = "countries/ZYZ - .txt"
ZYE = "countries/ZYE - .txt"
ZYA = "countries/ZYA - .txt"
ZYS = "countries/ZYS - .txt"
ZYL = "countries/ZYL - .txt"
ZYF = "countries/ZYF - .txt"
ZYB = "countries/ZYB - .txt"
ZYY = "countries/ZYY - .txt"
EOO = "countries/EOO - .txt"
EOI = "countries/EOI - .txt"
EOZ = "countries/EOZ - .txt"
EOE = "countries/EOE - .txt"
EOA = "countries/EOA - .txt"
EOS = "countries/EOS - .txt"
EOL = "countries/EOL - .txt"
EOF = "countries/EOF - .txt"
EOB = "countries/EOB - .txt"
EOY = "countries/EOY - .txt"
EIO = "countries/EIO - .txt"
EII = "countries/EII - .txt"
EIZ = "countries/EIZ - .txt"
EIE = "countries/EIE - .txt"
EIA = "countries/EIA - .txt"
EIS = "countries/EIS - .txt"
EIL = "countries/EIL - .txt"
EIF = "countries/EIF - .txt"
EIB = "countries/EIB - .txt"
EIY = "countries/EIY - .txt"
EZO = "countries/EZO - .txt"
EZI = "countries/EZI - .txt"
EZZ = "countries/EZZ - .txt"
EZE = "countries/EZE - .txt"
EZA = "countries/EZA - .txt"
EZS = "countries/EZS - .txt"
EZL = "countries/EZL - .txt"
EZF = "countries/EZF - .txt"
EZB = "countries/EZB - .txt"
EZY = "countries/EZY - .txt"
EEO = "countries/EEO - .txt"
EEI = "countries/EEI - .txt"
EEZ = "countries/EEZ - .txt"
EEE = "countries/EEE - .txt"
EEA = "countries/EEA - .txt"
EES = "countries/EES - .txt"
EEL = "countries/EEL - .txt"
EEF = "countries/EEF - .txt"
EEB = "countries/EEB - .txt"
EEY = "countries/EEY - .txt"
EAO = "countries/EAO - .txt"
EAI = "countries/EAI - .txt"
EAZ = "countries/EAZ - .txt"
EAE = "countries/EAE - .txt"
EAA = "countries/EAA - .txt"
EAS = "countries/EAS - .txt"
EAL = "countries/EAL - .txt"
EAF = "countries/EAF - .txt"
EAB = "countries/EAB - .txt"
EAY = "countries/EAY - .txt"
ESO = "countries/ESO - .txt"
ESI = "countries/ESI - .txt"
ESZ = "countries/ESZ - .txt"
ESE = "countries/ESE - .txt"
ESA = "countries/ESA - .txt"
ESS = "countries/ESS - .txt"
ESL = "countries/ESL - .txt"
ESF = "countries/ESF - .txt"
ESB = "countries/ESB - .txt"
ESY = "countries/ESY - .txt"
ELO = "countries/ELO - .txt"
ELI = "countries/ELI - .txt"
ELZ = "countries/ELZ - .txt"
ELE = "countries/ELE - .txt"
ELA = "countries/ELA - .txt"
FMT = "countries/FMT - .txt" # ELS
ELL = "countries/ELL - .txt"
ELF = "countries/ELF - .txt"
ELB = "countries/ELB - .txt"
ELY = "countries/ELY - .txt"
EFO = "countries/EFO - .txt"
EFI = "countries/EFI - .txt"
EFZ = "countries/EFZ - .txt"
EFE = "countries/EFE - .txt"
EFA = "countries/EFA - .txt"
EFS = "countries/EFS - .txt"
EFL = "countries/EFL - .txt"
EFF = "countries/EFF - .txt"
EFB = "countries/EFB - .txt"
EFY = "countries/EFY - .txt"
EBO = "countries/EBO - .txt"
EBI = "countries/EBI - .txt"
EBZ = "countries/EBZ - .txt"
EBE = "countries/EBE - .txt"
EBA = "countries/EBA - .txt"
EBS = "countries/EBS - .txt"
EBL = "countries/EBL - .txt"
EBF = "countries/EBF - .txt"
EBB = "countries/EBB - .txt"
EBY = "countries/EBY - .txt"
EYO = "countries/EYO - .txt"
EYI = "countries/EYI - .txt"
EYZ = "countries/EYZ - .txt"
EYE = "countries/EYE - .txt"
EYA = "countries/EYA - .txt"
EYS = "countries/EYS - .txt"
EYL = "countries/EYL - .txt"
EYF = "countries/EYF - .txt"
EYB = "countries/EYB - .txt"
EYY = "countries/EYY - .txt"
AOO = "countries/AOO - .txt"
BPJ = "countries/BPJ - .txt" # AOI
AOZ = "countries/AOZ - .txt"
AOE = "countries/AOE - .txt"
AOA = "countries/AOA - .txt"
AOS = "countries/AOS - .txt"
AOL = "countries/AOL - .txt"
AOF = "countries/AOF - .txt"
AOB = "countries/AOB - .txt"
AOY = "countries/AOY - .txt"
AIO = "countries/AIO - .txt"
AII = "countries/AII - .txt"
AIZ = "countries/AIZ - .txt"
AIE = "countries/AIE - .txt"
AIA = "countries/AIA - .txt"
AIS = "countries/AIS - .txt"
AIL = "countries/AIL - .txt"
AIF = "countries/AIF - .txt"
AIB = "countries/AIB - .txt"
AIY = "countries/AIY - .txt"
AZO = "countries/AZO - .txt"
AZI = "countries/AZI - .txt"
AZZ = "countries/AZZ - .txt"
AZE = "countries/AZE - .txt"
AZA = "countries/AZA - .txt"
AZS = "countries/AZS - .txt"
AZL = "countries/AZL - .txt"
AZF = "countries/AZF - .txt"
AZB = "countries/AZB - .txt"
AZY = "countries/AZY - .txt"
AEO = "countries/AEO - .txt"
AEI = "countries/AEI - .txt"
AEZ = "countries/AEZ - .txt"
AEE = "countries/AEE - .txt"
AEA = "countries/AEA - .txt"
AES = "countries/AES - .txt"
AEL = "countries/AEL - .txt"
AEF = "countries/AEF - .txt"
AEB = "countries/AEB - .txt"
AEY = "countries/AEY - .txt"
AAO = "countries/AAO - .txt"
AAI = "countries/AAI - .txt"
AAZ = "countries/AAZ - .txt"
AAE = "countries/AAE - .txt"
AAA = "countries/AAA - .txt"
AAS = "countries/AAS - .txt"
AAL = "countries/AAL - .txt"
AAF = "countries/AAF - .txt"
AAB = "countries/AAB - .txt"
AAY = "countries/AAY - .txt"
ASO = "countries/ASO - .txt"
ASI = "countries/ASI - .txt"
ASZ = "countries/ASZ - .txt"
ASE = "countries/ASE - .txt"
ASA = "countries/ASA - .txt"
ASS = "countries/ASS - .txt"
ASL = "countries/ASL - .txt"
ASF = "countries/ASF - .txt"
ASB = "countries/ASB - .txt"
ASY = "countries/ASY - .txt"
ALO = "countries/ALO - .txt"
ALI = "countries/ALI - .txt"
ALZ = "countries/ALZ - .txt"
ALE = "countries/ALE - .txt"
ALA = "countries/ALA - .txt"
ALS = "countries/ALS - .txt"
ALL = "countries/ALL - .txt"
ALF = "countries/ALF - .txt"
BMC = "countries/BMC - .txt" # ALB
ALY = "countries/ALY - .txt"
AFO = "countries/AFO - .txt"
AFI = "countries/AFI - .txt"
AFZ = "countries/AFZ - .txt"
AFE = "countries/AFE - .txt"
BGB = "countries/BGB - .txt" # AFA
AFS = "countries/AFS - .txt"
AFL = "countries/AFL - .txt"
AFF = "countries/AFF - .txt"
AFB = "countries/AFB - .txt"
AFY = "countries/AFY - .txt"
ABO = "countries/ABO - .txt"
ABI = "countries/ABI - .txt"
ABZ = "countries/ABZ - .txt"
ABE = "countries/ABE - .txt"
ABA = "countries/ABA - .txt"
ABS = "countries/ABS - .txt"
ABL = "countries/ABL - .txt"
ABF = "countries/ABF - .txt"
ABB = "countries/ABB - .txt"
ABY = "countries/ABY - .txt"
AYO = "countries/AYO - .txt"
AYI = "countries/AYI - .txt"
AYZ = "countries/AYZ - .txt"
AYE = "countries/AYE - .txt"
AYA = "countries/AYA - .txt"
AYS = "countries/AYS - .txt"
AYL = "countries/AYL - .txt"
AYF = "countries/AYF - .txt"
AYB = "countries/AYB - .txt"
AYY = "countries/AYY - .txt"
SOO = "countries/SOO - .txt"
SOI = "countries/SOI - .txt"
SOZ = "countries/SOZ - .txt"
SOE = "countries/SOE - .txt"
SOA = "countries/SOA - .txt"
SOS = "countries/SOS - .txt"
TPM = "countries/TPM - .txt" # SOL
SOF = "countries/SOF - .txt"
SOB = "countries/SOB - .txt"
SOY = "countries/SOY - .txt"
SIO = "countries/SIO - .txt"
SII = "countries/SII - .txt"
SIZ = "countries/SIZ - .txt"
TJF = "countries/TJF - .txt" # SIE
TJB = "countries/TJB - .txt" # SIA
SIS = "countries/SIS - .txt"
TJM = "countries/TJM - .txt" # SIL
SIF = "countries/SIF - .txt"
SIB = "countries/SIB - .txt"
SIY = "countries/SIY - .txt"
SZO = "countries/SZO - .txt"
SZI = "countries/SZI - .txt"
SZZ = "countries/SZZ - .txt"
SZE = "countries/SZE - .txt"
SZA = "countries/SZA - .txt"
SZS = "countries/SZS - .txt"
SZL = "countries/SZL - .txt"
SZF = "countries/SZF - .txt"
SZB = "countries/SZB - .txt"
SZY = "countries/SZY - .txt"
SEO = "countries/SEO - .txt"
SEI = "countries/SEI - .txt"
SEZ = "countries/SEZ - .txt"
SEE = "countries/SEE - .txt"
SEA = "countries/SEA - .txt"
SES = "countries/SES - .txt"
SEL = "countries/SEL - .txt"
SEF = "countries/SEF - .txt"
SEB = "countries/SEB - .txt"
SEY = "countries/SEY - .txt"
SAO = "countries/SAO - .txt"
SAI = "countries/SAI - .txt"
SAZ = "countries/SAZ - .txt"
SAE = "countries/SAE - .txt"
SAA = "countries/SAA - .txt"
SAS = "countries/SAS - .txt"
SAL = "countries/SAL - .txt"
TBG = "countries/TBG - .txt" # SAF
SAB = "countries/SAB - .txt"
SAY = "countries/SAY - .txt"
SSO = "countries/SSO - .txt"
SSI = "countries/SSI - .txt"
SSZ = "countries/SSZ - .txt"
SSE = "countries/SSE - .txt"
SSA = "countries/SSA - .txt"
SSS = "countries/SSS - .txt"
SSL = "countries/SSL - .txt"
SSF = "countries/SSF - .txt"
SSB = "countries/SSB - .txt"
SSY = "countries/SSY - .txt"
TMP = "countries/TMP - .txt" # SLO
SLI = "countries/SLI - .txt"
SLZ = "countries/SLZ - .txt"
SLE = "countries/SLE - .txt"
SLA = "countries/SLA - .txt"
SLS = "countries/SLS - .txt"
SLL = "countries/SLL - .txt"
SLF = "countries/SLF - .txt"
SLB = "countries/SLB - .txt"
SLY = "countries/SLY - .txt"
SFO = "countries/SFO - .txt"
SFI = "countries/SFI - .txt"
SFZ = "countries/SFZ - .txt"
SFE = "countries/SFE - .txt"
SFA = "countries/SFA - .txt"
SFS = "countries/SFS - .txt"
SFL = "countries/SFL - .txt"
SFF = "countries/SFF - .txt"
SFB = "countries/SFB - .txt"
SFY = "countries/SFY - .txt"
SBO = "countries/SBO - .txt"
SBI = "countries/SBI - .txt"
SBZ = "countries/SBZ - .txt"
SBE = "countries/SBE - .txt"
SBA = "countries/SBA - .txt"
SBS = "countries/SBS - .txt"
SBL = "countries/SBL - .txt"
SBF = "countries/SBF - .txt"
SBB = "countries/SBB - .txt"
SBY = "countries/SBY - .txt"
SYO = "countries/SYO - .txt"
SYI = "countries/SYI - .txt"
SYZ = "countries/SYZ - .txt"
SYE = "countries/SYE - .txt"
SYA = "countries/SYA - .txt"
SYS = "countries/SYS - .txt"
SYL = "countries/SYL - .txt"
SYF = "countries/SYF - .txt"
SYB = "countries/SYB - .txt"
SYY = "countries/SYY - .txt"
LOO = "countries/LOO - .txt"
LOI = "countries/LOI - .txt"
LOZ = "countries/LOZ - .txt"
LOE = "countries/LOE - .txt"
LOA = "countries/LOA - .txt"
LOS = "countries/LOS - .txt"
LOL = "countries/LOL - .txt"
LOF = "countries/LOF - .txt"
LOB = "countries/LOB - .txt"
LOY = "countries/LOY - .txt"
LIO = "countries/LIO - .txt"
LII = "countries/LII - .txt"
LIZ = "countries/LIZ - .txt"
LIE = "countries/LIE - .txt"
LIA = "countries/LIA - .txt"
LIS = "countries/LIS - .txt"
LIL = "countries/LIL - .txt"
LIF = "countries/LIF - .txt"
MJC = "countries/MJC - .txt" # LIB
LIY = "countries/LIY - .txt"
LZO = "countries/LZO - .txt"
LZI = "countries/LZI - .txt"
LZZ = "countries/LZZ - .txt"
LZE = "countries/LZE - .txt"
LZA = "countries/LZA - .txt"
LZS = "countries/LZS - .txt"
LZL = "countries/LZL - .txt"
LZF = "countries/LZF - .txt"
LZB = "countries/LZB - .txt"
LZY = "countries/LZY - .txt"
LEO = "countries/LEO - .txt"
LEI = "countries/LEI - .txt"
LEZ = "countries/LEZ - .txt"
LEE = "countries/LEE - .txt"
LEA = "countries/LEA - .txt"
LES = "countries/LES - .txt"
LEL = "countries/LEL - .txt"
LEF = "countries/LEF - .txt"
MFC = "countries/MFC - .txt" # LEB
LEY = "countries/LEY - .txt"
MBP = "countries/MBP - .txt" # LAO
LAI = "countries/LAI - .txt"
LAZ = "countries/LAZ - .txt"
LAE = "countries/LAE - .txt"
LAA = "countries/LAA - .txt"
LAS = "countries/LAS - .txt"
LAL = "countries/LAL - .txt"
LAF = "countries/LAF - .txt"
LAB = "countries/LAB - .txt"
LAY = "countries/LAY - .txt"
LSO = "countries/LSO - .txt"
LSI = "countries/LSI - .txt"
LSZ = "countries/LSZ - .txt"
LSE = "countries/LSE - .txt"
LSA = "countries/LSA - .txt"
LSS = "countries/LSS - .txt"
LSL = "countries/LSL - .txt"
LSF = "countries/LSF - .txt"
LSB = "countries/LSB - .txt"
LSY = "countries/LSY - .txt"
LLO = "countries/LLO - .txt"
LLI = "countries/LLI - .txt"
LLZ = "countries/LLZ - .txt"
LLE = "countries/LLE - .txt"
LLA = "countries/LLA - .txt"
LLS = "countries/LLS - .txt"
LLL = "countries/LLL - .txt"
LLF = "countries/LLF - .txt"
LLB = "countries/LLB - .txt"
LLY = "countries/LLY - .txt"
LFO = "countries/LFO - .txt"
LFI = "countries/LFI - .txt"
LFZ = "countries/LFZ - .txt"
LFE = "countries/LFE - .txt"
LFA = "countries/LFA - .txt"
LFS = "countries/LFS - .txt"
LFL = "countries/LFL - .txt"
LFF = "countries/LFF - .txt"
LFB = "countries/LFB - .txt"
LFY = "countries/LFY - .txt"
LBO = "countries/LBO - .txt"
LBI = "countries/LBI - .txt"
LBZ = "countries/LBZ - .txt"
LBE = "countries/LBE - .txt"
MCB = "countries/MCB - .txt" # LBA
LBS = "countries/LBS - .txt"
LBL = "countries/LBL - .txt"
LBF = "countries/LBF - .txt"
LBB = "countries/LBB - .txt"
LBY = "countries/LBY - .txt"
LYO = "countries/LYO - .txt"
LYI = "countries/LYI - .txt"
LYZ = "countries/LYZ - .txt"
LYE = "countries/LYE - .txt"
LYA = "countries/LYA - .txt"
LYS = "countries/LYS - .txt"
LYL = "countries/LYL - .txt"
LYF = "countries/LYF - .txt"
LYB = "countries/LYB - .txt"
LYY = "countries/LYY - .txt"
FOO = "countries/FOO - .txt"
FOI = "countries/FOI - .txt"
FOZ = "countries/FOZ - .txt"
FOE = "countries/FOE - .txt"
FOA = "countries/FOA - .txt"
FOS = "countries/FOS - .txt"
FOL = "countries/FOL - .txt"
FOF = "countries/FOF - .txt"
FOB = "countries/FOB - .txt"
FOY = "countries/FOY - .txt"
FIO = "countries/FIO - .txt"
FII = "countries/FII - .txt"
FIZ = "countries/FIZ - .txt"
FIE = "countries/FIE - .txt"
FIA = "countries/FIA - .txt"
FIS = "countries/FIS - .txt"
FIL = "countries/FIL - .txt"
FIF = "countries/FIF - .txt"
FIB = "countries/FIB - .txt"
FIY = "countries/FIY - .txt"
FZO = "countries/FZO - .txt"
FZI = "countries/FZI - .txt"
FZZ = "countries/FZZ - .txt"
FZE = "countries/FZE - .txt"
FZA = "countries/FZA - .txt"
FZS = "countries/FZS - .txt"
FZL = "countries/FZL - .txt"
FZF = "countries/FZF - .txt"
FZB = "countries/FZB - .txt"
FZY = "countries/FZY - .txt"
FEO = "countries/FEO - .txt"
FEI = "countries/FEI - .txt"
FEZ = "countries/FEZ - .txt"
FEE = "countries/FEE - .txt"
FEA = "countries/FEA - .txt"
FES = "countries/FES - .txt"
FEL = "countries/FEL - .txt"
FEF = "countries/FEF - .txt"
FEB = "countries/FEB - .txt"
FEY = "countries/FEY - .txt"
FAO = "countries/FAO - .txt"
FAI = "countries/FAI - .txt"
FAZ = "countries/FAZ - .txt"
FAE = "countries/FAE - .txt"
FAA = "countries/FAA - .txt"
FAS = "countries/FAS - .txt"
FAL = "countries/FAL - .txt"
FAF = "countries/FAF - .txt"
FAB = "countries/FAB - .txt"
FAY = "countries/FAY - .txt"
FSO = "countries/FSO - .txt"
FSI = "countries/FSI - .txt"
FSZ = "countries/FSZ - .txt"
FSE = "countries/FSE - .txt"
FSA = "countries/FSA - .txt"
FSS = "countries/FSS - .txt"
FSL = "countries/FSL - .txt"
FSF = "countries/FSF - .txt"
FSB = "countries/FSB - .txt"
FSY = "countries/FSY - .txt"
FLO = "countries/FLO - .txt"
FLI = "countries/FLI - .txt"
FLZ = "countries/FLZ - .txt"
FLE = "countries/FLE - .txt"
FLA = "countries/FLA - .txt"
FLS = "countries/FLS - .txt"
FLL = "countries/FLL - .txt"
FLF = "countries/FLF - .txt"
FLB = "countries/FLB - .txt"
FLY = "countries/FLY - .txt"
FFO = "countries/FFO - .txt"
FFI = "countries/FFI - .txt"
FFZ = "countries/FFZ - .txt"
FFE = "countries/FFE - .txt"
FFA = "countries/FFA - .txt"
FFS = "countries/FFS - .txt"
FFL = "countries/FFL - .txt"
FFF = "countries/FFF - .txt"
FFB = "countries/FFB - .txt"
FFY = "countries/FFY - .txt"
FBO = "countries/FBO - .txt"
FBI = "countries/FBI - .txt"
FBZ = "countries/FBZ - .txt"
FBE = "countries/FBE - .txt"
FBA = "countries/FBA - .txt"
FBS = "countries/FBS - .txt"
FBL = "countries/FBL - .txt"
FBF = "countries/FBF - .txt"
FBB = "countries/FBB - .txt"
FBY = "countries/FBY - .txt"
FYO = "countries/FYO - .txt"
FYI = "countries/FYI - .txt"
FYZ = "countries/FYZ - .txt"
FYE = "countries/FYE - .txt"
FYA = "countries/FYA - .txt"
FYS = "countries/FYS - .txt"
FYL = "countries/FYL - .txt"
FYF = "countries/FYF - .txt"
FYB = "countries/FYB - .txt"
FYY = "countries/FYY - .txt"
BOO = "countries/BOO - .txt"
BOI = "countries/BOI - .txt"
BOZ = "countries/BOZ - .txt"
BOE = "countries/BOE - .txt"
BOA = "countries/BOA - .txt"
CPT = "countries/CPT - .txt" # BOS
CPM = "countries/CPM - .txt" # BOL
BOF = "countries/BOF - .txt"
BOB = "countries/BOB - .txt"
BOY = "countries/BOY - .txt"
BIO = "countries/BIO - .txt"
BII = "countries/BII - .txt"
BIZ = "countries/BIZ - .txt"
BIE = "countries/BIE - .txt"
BIA = "countries/BIA - .txt"
BIS = "countries/BIS - .txt"
BIL = "countries/BIL - .txt"
BIF = "countries/BIF - .txt"
BIB = "countries/BIB - .txt"
BIY = "countries/BIY - .txt"
BZO = "countries/BZO - .txt"
BZI = "countries/BZI - .txt"
BZZ = "countries/BZZ - .txt"
BZE = "countries/BZE - .txt"
BZA = "countries/BZA - .txt"
BZS = "countries/BZS - .txt"
BZL = "countries/BZL - .txt"
BZF = "countries/BZF - .txt"
BZB = "countries/BZB - .txt"
BZY = "countries/BZY - .txt"
BEO = "countries/BEO - .txt"
BEI = "countries/BEI - .txt"
BEZ = "countries/BEZ - .txt"
BEE = "countries/BEE - .txt"
BEA = "countries/BEA - .txt"
BES = "countries/BES - .txt"
CFM = "countries/CFM - .txt" # BEL
BEF = "countries/BEF - .txt"
BEB = "countries/BEB - .txt"
BEY = "countries/BEY - .txt"
BAO = "countries/BAO - .txt"
BAI = "countries/BAI - .txt"
BAZ = "countries/BAZ - .txt"
BAE = "countries/BAE - .txt"
BAA = "countries/BAA - .txt"
CBT = "countries/CBT - .txt" # BAS
BAL = "countries/BAL - .txt"
BAF = "countries/BAF - .txt"
BAB = "countries/BAB - .txt"
CBZ = "countries/CBZ - .txt" # BAY
BSO = "countries/BSO - .txt"
BSI = "countries/BSI - .txt"
BSZ = "countries/BSZ - .txt"
BSE = "countries/BSE - .txt"
BSA = "countries/BSA - .txt"
BSS = "countries/BSS - .txt"
BSL = "countries/BSL - .txt"
BSF = "countries/BSF - .txt"
BSB = "countries/BSB - .txt"
BSY = "countries/BSY - .txt"
BLO = "countries/BLO - .txt"
BLI = "countries/BLI - .txt"
CMA = "countries/CMA - .txt" # BLZ
BLE = "countries/BLE - .txt"
BLA = "countries/BLA - .txt"
BLS = "countries/BLS - .txt"
BLL = "countries/BLL - .txt"
BLF = "countries/BLF - .txt"
BLB = "countries/BLB - .txt"
BLY = "countries/BLY - .txt"
BFO = "countries/BFO - .txt"
BFI = "countries/BFI - .txt"
BFZ = "countries/BFZ - .txt"
BFE = "countries/BFE - .txt"
BFA = "countries/BFA - .txt"
BFS = "countries/BFS - .txt"
BFL = "countries/BFL - .txt"
BFF = "countries/BFF - .txt"
BFB = "countries/BFB - .txt"
BFY = "countries/BFY - .txt"
BBO = "countries/BBO - .txt"
BBI = "countries/BBI - .txt"
BBZ = "countries/BBZ - .txt"
BBE = "countries/BBE - .txt"
BBA = "countries/BBA - .txt"
BBS = "countries/BBS - .txt"
BBL = "countries/BBL - .txt"
BBF = "countries/BBF - .txt"
BBB = "countries/BBB - .txt"
BBY = "countries/BBY - .txt"
BYO = "countries/BYO - .txt"
BYI = "countries/BYI - .txt"
BYZ = "countries/BYZ - .txt"
BYE = "countries/BYE - .txt"
CZB = "countries/CZB - .txt" # BYA
BYS = "countries/BYS - .txt"
BYL = "countries/BYL - .txt"
BYF = "countries/BYF - .txt"
BYB = "countries/BYB - .txt"
BYY = "countries/BYY - .txt"
YOO = "countries/YOO - .txt"
YOI = "countries/YOI - .txt"
YOZ = "countries/YOZ - .txt"
YOE = "countries/YOE - .txt"
YOA = "countries/YOA - .txt"
YOS = "countries/YOS - .txt"
YOL = "countries/YOL - .txt"
YOF = "countries/YOF - .txt"
YOB = "countries/YOB - .txt"
YOY = "countries/YOY - .txt"
YIO = "countries/YIO - .txt"
YII = "countries/YII - .txt"
YIZ = "countries/YIZ - .txt"
YIE = "countries/YIE - .txt"
YIA = "countries/YIA - .txt"
YIS = "countries/YIS - .txt"
YIL = "countries/YIL - .txt"
YIF = "countries/YIF - .txt"
YIB = "countries/YIB - .txt"
YIY = "countries/YIY - .txt"
YZO = "countries/YZO - .txt"
YZI = "countries/YZI - .txt"
YZZ = "countries/YZZ - .txt"
YZE = "countries/YZE - .txt"
YZA = "countries/YZA - .txt"
YZS = "countries/YZS - .txt"
YZL = "countries/YZL - .txt"
YZF = "countries/YZF - .txt"
YZB = "countries/YZB - .txt"
YZY = "countries/YZY - .txt"
YEO = "countries/YEO - .txt"
YEI = "countries/YEI - .txt"
YEZ = "countries/YEZ - .txt"
YEE = "countries/YEE - .txt"
YEA = "countries/YEA - .txt"
ZFT = "countries/ZFT - .txt" # YES # Not a basegame tag, but conflicts with button string. 
YEL = "countries/YEL - .txt"
YEF = "countries/YEF - .txt"
YEB = "countries/YEB - .txt"
YEY = "countries/YEY - .txt"
YAO = "countries/YAO - .txt"
YAI = "countries/YAI - .txt"
YAZ = "countries/YAZ - .txt"
YAE = "countries/YAE - .txt"
YAA = "countries/YAA - .txt"
YAS = "countries/YAS - .txt"
YAL = "countries/YAL - .txt"
YAF = "countries/YAF - .txt"
YAB = "countries/YAB - .txt"
YAY = "countries/YAY - .txt"
YSO = "countries/YSO - .txt"
YSI = "countries/YSI - .txt"
YSZ = "countries/YSZ - .txt"
YSE = "countries/YSE - .txt"
YSA = "countries/YSA - .txt"
YSS = "countries/YSS - .txt"
YSL = "countries/YSL - .txt"
YSF = "countries/YSF - .txt"
YSB = "countries/YSB - .txt"
YSY = "countries/YSY - .txt"
YLO = "countries/YLO - .txt"
YLI = "countries/YLI - .txt"
YLZ = "countries/YLZ - .txt"
YLE = "countries/YLE - .txt"
YLA = "countries/YLA - .txt"
YLS = "countries/YLS - .txt"
YLL = "countries/YLL - .txt"
YLF = "countries/YLF - .txt"
YLB = "countries/YLB - .txt"
YLY = "countries/YLY - .txt"
